Lecturer,Fact,Next step,Proof framework,Warrant,Evaluation,Convention,Other,Total
L1,12,4,2,4,4,11,7,44
L2,21,23,12,10,1,1,13,81
L3,29,8,0,12,2,1,1,53
L4,41,8,0,1,1,3,1,55
L5,18,1,0,3,7,2,1,32
L6,7,3,3,5,0,0,0,18
L7,64,5,0,5,4,1,8,87
L8,81,55,13,19,9,7,18,202
L9,8,6,0,2,2,1,7,26
L10,0,0,1,1,0,0,2,4
L11,8,4,0,0,4,0,1,17
